1111111111111111111111111111111111
1E0000000000000C00000C000000000001
1010010100100000010100100000010101
1010010010101010000010010000010101
1P00000000C00C000000000000000000C1
1111111111111111111111111111111111